001000000
001000000
011111110
010000010
010001110
011111000
000001000